5,0,3,0,0,7,0
4,0,0,0,0,7,0
4,0,3,0,3,6,0
3,0,0,3,5,3,3
5,1,7,3,0,0,0
4,1,7,0,0,0,0
4,1,6,3,0,3,0
3,1,3,0,3,5,3
5,2,0,0,3,0,7
4,2,0,0,0,0,7
4,2,0,3,6,0,3
3,2,0,5,3,3,3
5,3,0,0,7,3,0
4,3,0,0,7,0,0
4,3,0,0,6,3,3
3,3,3,3,3,0,5
5,4,0,7,0,0,3
4,4,0,7,0,0,0
4,4,3,6,0,0,3
3,4,5,3,3,3,0